1U1U1U1U1U1U1U1U1U1U
22222222222222222222
3U3U3U3U3U3U3U3U3U3U
44444444444444444444
5U5U5U5U5U5U5U5U5U5U
66666666666666666666
7U7U7U7U7U7U7U7U7U7U
88888888888888888888
9U9U9U9U9U9U9U9U9U9U
