1 1 1 1 1 1 1 1 1 1
 U U U U U U U U U U
2 2 2 2 2 2 2 2 2 2
 U U U U U U U U U U
3 3 3 3 3 3 3 3 3 3
 U U U U U U U U U U
4 4 4 4 4 4 4 4 4 4
 U U U U U U U U U U
5 5 5 5 5 5 5 5 5 5
